%%%%%
% P %
% % %
%  %%
% .%%
%%%%%
